workman : 노동자, 장인, 직공
blame : 나무라다, 비난하다, 비난, 책망
according to : ~에 따르다
term : 기간, 기한
describe : 묘사하다, 기술하다
contemporary : 같은시대의, 그당시의, 현대의
entire : 전체, 전체의
depth : 깊이, 깊은정도
acquaintance : 지인, 아는사람
forward : 앞으로
plant : 식물
valuables : 귀중품
experience : 경험
priceless : 아주 귀중한
lesson : 수업, 연습
nobody : 아무도 ~않다
bring : 가져오다, 데려오다
imagination : 상상력
offer : 제공하다, 제출하다
librarian : 사서
accepting : 쾌히 받아들이는, 솔직한
imperfection : 불완전, 불충분
knowledgeable : 지식있는
uncommonly : 흔치않은
drove : 운전 했다
kept : 유지했다
awake : 깨우다, 깨어나다, 깨어있는
educational : 교육상의, 교육적인
commentator : 해설자
considered : 깊이 생각한, 존경받는, 여겨지는
useful : 쓸모있는, 유용한, 유익한
resource : 자원
environmentally : 환경적으로
discuss : 토론하다, 토의하다
cause : 원인, 이유
reach : ~에 도착하다
lying : 거짓말, 누워있다
modern science : 현대 과학
assistance : 보조, 도움
period : 기간, 시기
glacier : 빙하
melt : 용해, 녹다
raise : 올리다, 일으키다, 세우다
explain : 설명하다, 해석하다
introduce : 소개하다, 만나게해주다
suggest : 암시하다, 생각나게하다, 제안하다