durable : 내구성이 좋은, 오래가는
nomination : 지명, 추천, 임명
steady : 꾸준한, 균형을잡다, 흔들리지 않다
leading : 가장 중요한, 선두하는
qualified : 자격이 있는
imperative : 반드시 해야 하는, 긴요한
outreach : 봉사 활동
assemble : 모이다, 집합시키다/조립하다
endorse : 지지하다, 보증[홍보]하다
disclose : 밝히다, 폭로하다, 드러내다
commemorate : (중요 인물 사건을)기념하다
terminate : 끝나다, 종점에 달하다
account : 계좌/장부/계정/설명, 설명하다(for), 차지하다(for)
extension : 확대/증축 된 건물
congestion : 혼잡
substantially : 상당히, 많이
mainly : 주로, 대부분, 대개
accurate : 정확한, 정밀한
complete : 완벽한, 완전한, 완료하다, 끝마치다/기입하다
separate : 분리된, 독립된, 분리하다, 갈라지다
patron : 후원자, 고객
testimonial : 추천서, 추천의 글
extend : 더 길게 만들다, 연장하다
power outage : 정전
avid : 열심인, 열렬한, 열망하는
make a mistake : 실수하다, 잘못 생각하다
respond to : ~에 응답/대응하다
conveniently located : 편리한 위치에 있는
highly regard : ~을 중시하다
on duty : 근무 중